1 13 31
###############################
#p     ** *  1 *   *  * * *   #
# # # #*# # #*#*# # # #*#*#*# #
#  x*2    ***  *      *   * * #
# # # # # #*# # #*#*# # # # #*#
#f  2   1  x **  *  *         #
# # # # # # # # # #*# #*# # # #
#*  *      *  *          2    #
# # # # #*# # # #*#*# # # # # #
#*    **  *   k   *      2    #
# #*# # # # # # #*# # # # # # #
#      1s   *   *  *   b 1    #
###############################