1 13 31
###############################
#pk    ** *  1 *   *  * * *   #
# # # #*# # #*#*# # # #*#*#*# #
#c x*2    ***  *      *   * * #
# # # # # #*# # #*#*# # # # #*#
#f  2   1  x **  *  *         #
# # # # # # # # # #*# #*# # # #
#*  *      *  *          2    #
# # # # #*# # # #*#*# # # # # #
#*    **  *       *      2    #
# #*# # # # # # #*# # # # # # #
#      1s   *   *  *   b 1    #
###############################