1 13 31
###############################
#p1    ** *  1 * 2 *  * * *   #
# # # #*# # #*#*# # # #*#*#*# #
#  x*2    ***  *  1   * 2 * * #
# # # # # #*# # #*#*# # # # #*#
#f      1  x **  *  *   1     #
# # # # # # # # # #*# #*# # # #
#*  *      *  *               #
# # # # #*# # # #*#*# # # # # #
#*    **  *   k   *        2  #
# #*# # # # # # #*# # # # # # #
#1      s   *   *  *   b      #
###############################