1 13 15
t#############t
#             #
#             #
#    fff      #
#    skb      #
#             #
#      t      #
#             #
#             #
#p            #
#             #
#             #
t#############t