1 15 17
t###############t
#pbf*** * #   **#
#s*#  * #   #   #
#k    *   #*****#
#h#* #  ** *    #
#  *#    ***    #
#     ***   2   #
#**#**  ***     #
# *    th       #
#  *   h * #*#**#
# *1     *      #
#  ######*      #
# *   *  * # #* #
#1    *      # f#
t###############t