2 17 15
#################
#p**#f  1*    *b#
#b#*###*# #***#*#
#s  #  ***     2#
# **# # #k#*#*#*#
#   *2   *1   *s#
# # # # # # # # #
#   1  * * 2    #
# # # # #*#*# # #
#   **    *    2#
#*#*# # # #*# #*#
#  *    1s    **#
# # # # #***#*###
#2   *  *     1 #
#################