1 13 31
###############################
#p                            #
#                             #
#          *        *         #
#                       2     #
#                       1     #
#                             #
#                             #
#          *        *         #
#                      B      #
#                             #
#  bbbb sssfff                #
###############################
