2 17 15
#################
#p*1*f   *    *b#
#b#*# #*# #*# #*#
#      ***      #
# # # # #k# # #*#
#        *    *s#
# # # # # # # # #
#   f  * *      #
# # # # #*#*# # #
#   **    *f    #
# # # # # # # #*#
# * **        **#
# # # # # # # ###
#               #
#################