1 15 17
t###############t
#               #
#               #
#      bbb      #
#        ***    #
#    fff ***    #
#    skb        #
#    s          #
#      th       #
#      h        #
#           1   #
#p B         2  #
#               #
#      1        #
t###############t